111111111
1P000C001
1000C00C1
100000001
100E00001
111111111